고객정보	NNG
공동인증서	NNP
금융인증서	NNG
간편인증	NNG
바이오인증	NNG
본인인증	NNG
운전면허증	NNP
주민등록증	NNP
한국증권금융	NNP
우리사주	NNG
계좌인증	NNG
1원인증	NNG
계좌번호	NNG
버퍼링	NNG
인터넷뱅킹	NNP
우리사주뱅킹	NNP
모바일뱅킹	NNP
파킹통장	NNG
편의성	NNG
비대면	NNG
리뉴얼	NNG
무결성	NNG
로그인	NNG
인증서	NNG
인증센터	NNG
공공기관	NNG
타기관	NNG
재설치	NNG
UI	NNG
UX	NNG
